1111111111111111111
10000C0000000000011
10000000000000E0001
1000000000000000001
1000000P00000000001
1000000000000000001
1000100C00000000001
10000000C0000000101
1111111111111111111
