1111111111111111111111111111111111111111111111111111111111111111111111111111111111111111111111111111111111111111111111111111111
10000000000000000000000000000000000000000000000000000000000000000000000000000000000000000000000000000000000000000C0000000000011
10000000000000000000000000000000000000000000000000000000000000000000000000000000000000000000000000000000000000000000000000E0001
1000000000000000000000000000000000000000000000000000000000000000000000000000000000000000000000000000000000000000000000000000001
1000000000000000000000000000000000000000000000000000000000000000000000000000000000000000000000000000000000000000000P00000000001
1000000000000000000000000000000000000000000000000000000000000000000000000000000000000000000000000000000000000000000000000000001
1000000000000000000000000000000000000000000000000000000000000000000000000000000000000000000000000000000000000000100C00000000001
1000000000000000000000000000000000000000000000000000000000000000000000000000000000000000000000000000000000000000100C00000000001
1000000000000000000000000000000000000000000000000000000000000000000000000000000000000000000000000000000000000000100C00000000001
1000000000000000000000000000000000000000000000000000000000000000000000000000000000000000000000000000000000000000100C00000000001
1000000000000000000000000000000000000000000000000000000000000000000000000000000000000000000000000000000000000000100C00000000001
1000000000000000000000000000000000000000000000000000000000000000000000000000000000000000000000000000000000000000100C00000000001
1000000000000000000000000000000000000000000000000000000000000000000000000000000000000000000000000000000000000000100C00000000001
1000000000000000000000000000000000000000000000000000000000000000000000000000000000000000000000000000000000000000100C00000000001
1000000000000000000000000000000000000000000000000000000000000000000000000000000000000000000000000000000000000000100C00000000001
1000000000000000000000000000000000000000000000000000000000000000000000000000000000000000000000000000000000000000100C00000000001
1000000000000000000000000000000000000000000000000000000000000000000000000000000000000000000000000000000000000000100C00000000001
1000000000000000000000000000000000000000000000000000000000000000000000000000000000000000000000000000000000000000100C00000000001
1000000000000000000000000000000000000000000000000000000000000000000000000000000000000000000000000000000000000000100C00000000001
1000000000000000000000000000000000000000000000000000000000000000000000000000000000000000000000000000000000000000100C00000000001
1000000000000000000000000000000000000000000000000000000000000000000000000000000000000000000000000000000000000000100C00000000001
1000000000000000000000000000000000000000000000000000000000000000000000000000000000000000000000000000000000000000100C00000000001
1000000000000000000000000000000000000000000000000000000000000000000000000000000000000000000000000000000000000000100C00000000001
1000000000000000000000000000000000000000000000000000000000000000000000000000000000000000000000000000000000000000100C00000000001
1000000000000000000000000000000000000000000000000000000000000000000000000000000000000000000000000000000000000000100C00000000001
1000000000000000000000000000000000000000000000000000000000000000000000000000000000000000000000000000000000000000100C00000000001
1000000000000000000000000000000000000000000000000000000000000000000000000000000000000000000000000000000000000000100C00000000001
1000000000000000000000000000000000000000000000000000000000000000000000000000000000000000000000000000000000000000100C00000000001
1000000000000000000000000000000000000000000000000000000000000000000000000000000000000000000000000000000000000000100C00000000001
1000000000000000000000000000000000000000000000000000000000000000000000000000000000000000000000000000000000000000100C00000000001
1000000000000000000000000000000000000000000000000000000000000000000000000000000000000000000000000000000000000000100C00000000001
1000000000000000000000000000000000000000000000000000000000000000000000000000000000000000000000000000000000000000100C00000000001
1000000000000000000000000000000000000000000000000000000000000000000000000000000000000000000000000000000000000000100C00000000001
1000000000000000000000000000000000000000000000000000000000000000000000000000000000000000000000000000000000000000100C00000000001
1000000000000000000000000000000000000000000000000000000000000000000000000000000000000000000000000000000000000000100C00000000001
1000000000000000000000000000000000000000000000000000000000000000000000000000000000000000000000000000000000000000100C00000000001
1000000000000000000000000000000000000000000000000000000000000000000000000000000000000000000000000000000000000000100C00000000001
1000000000000000000000000000000000000000000000000000000000000000000000000000000000000000000000000000000000000000100C00000000001
1000000000000000000000000000000000000000000000000000000000000000000000000000000000000000000000000000000000000000100C00000000001
1000000000000000000000000000000000000000000000000000000000000000000000000000000000000000000000000000000000000000100C00000000001
1000000000000000000000000000000000000000000000000000000000000000000000000000000000000000000000000000000000000000100C00000000001
1000000000000000000000000000000000000000000000000000000000000000000000000000000000000000000000000000000000000000100C00000000001
1000000000000000000000000000000000000000000000000000000000000000000000000000000000000000000000000000000000000000100C00000000001
1000000000000000000000000000000000000000000000000000000000000000000000000000000000000000000000000000000000000000100C00000000001
1000000000000000000000000000000000000000000000000000000000000000000000000000000000000000000000000000000000000000100C00000000001
1000000000000000000000000000000000000000000000000000000000000000000000000000000000000000000000000000000000000000100C00000000001
1000000000000000000000000000000000000000000000000000000000000000000000000000000000000000000000000000000000000000100C00000000001
1000000000000000000000000000000000000000000000000000000000000000000000000000000000000000000000000000000000000000100C00000000001
1000000000000000000000000000000000000000000000000000000000000000000000000000000000000000000000000000000000000000100C00000000001
1000000000000000000000000000000000000000000000000000000000000000000000000000000000000000000000000000000000000000100C00000000001
1000000000000000000000000000000000000000000000000000000000000000000000000000000000000000000000000000000000000000100C00000000001
1000000000000000000000000000000000000000000000000000000000000000000000000000000000000000000000000000000000000000100C00000000001
1000000000000000000000000000000000000000000000000000000000000000000000000000000000000000000000000000000000000000100C00000000001
1000000000000000000000000000000000000000000000000000000000000000000000000000000000000000000000000000000000000000100C00000000001
1000000000000000000000000000000000000000000000000000000000000000000000000000000000000000000000000000000000000000100C00000000001
1000000000000000000000000000000000000000000000000000000000000000000000000000000000000000000000000000000000000000100C00000000001
1000000000000000000000000000000000000000000000000000000000000000000000000000000000000000000000000000000000000000100C00000000001
1000000000000000000000000000000000000000000000000000000000000000000000000000000000000000000000000000000000000000100C00000000001
1000000000000000000000000000000000000000000000000000000000000000000000000000000000000000000000000000000000000000100C00000000001
1000000000000000000000000000000000000000000000000000000000000000000000000000000000000000000000000000000000000000100C00000000001
1000000000000000000000000000000000000000000000000000000000000000000000000000000000000000000000000000000000000000100C00000000001
1000000000000000000000000000000000000000000000000000000000000000000000000000000000000000000000000000000000000000100C00000000001
1000000000000000000000000000000000000000000000000000000000000000000000000000000000000000000000000000000000000000100C00000000001
1000000000000000000000000000000000000000000000000000000000000000000000000000000000000000000000000000000000000000100C00000000001
1000000000000000000000000000000000000000000000000000000000000000000000000000000000000000000000000000000000000000100C00000000001
1000000000000000000000000000000000000000000000000000000000000000000000000000000000000000000000000000000000000000100C00000000001
1000000000000000000000000000000000000000000000000000000000000000000000000000000000000000000000000000000000000000100C00000000001
1000000000000000000000000000000000000000000000000000000000000000000000000000000000000000000000000000000000000000100C00000000001
1000000000000000000000000000000000000000000000000000000000000000000000000000000000000000000000000000000000000000100C00000000001
1000000000000000000000000000000000000000000000000000000000000000000000000000000000000000000000000000000000000000100C00000000001
1000000000000000000000000000000000000000000000000000000000000000000000000000000000000000000000000000000000000000100C00000000001
1000000000000000000000000000000000000000000000000000000000000000000000000000000000000000000000000000000000000000100C00000000001
1000000000000000000000000000000000000000000000000000000000000000000000000000000000000000000000000000000000000000100C00000000001
1000000000000000000000000000000000000000000000000000000000000000000000000000000000000000000000000000000000000000100C00000000001
1000000000000000000000000000000000000000000000000000000000000000000000000000000000000000000000000000000000000000100C00000000001
1000000000000000000000000000000000000000000000000000000000000000000000000000000000000000000000000000000000000000100C00000000001
1000000000000000000000000000000000000000000000000000000000000000000000000000000000000000000000000000000000000000100C00000000001
1000000000000000000000000000000000000000000000000000000000000000000000000000000000000000000000000000000000000000100C00000000001
1000000000000000000000000000000000000000000000000000000000000000000000000000000000000000000000000000000000000000100C00000000001
1000000000000000000000000000000000000000000000000000000000000000000000000000000000000000000000000000000000000000100C00000000001
1000000000000000000000000000000000000000000000000000000000000000000000000000000000000000000000000000000000000000100C00000000001
1000000000000000000000000000000000000000000000000000000000000000000000000000000000000000000000000000000000000000100C00000000001
1000000000000000000000000000000000000000000000000000000000000000000000000000000000000000000000000000000000000000100C00000000001
1000000000000000000000000000000000000000000000000000000000000000000000000000000000000000000000000000000000000000100C00000000001
1000000000000000000000000000000000000000000000000000000000000000000000000000000000000000000000000000000000000000000000000000101
1111111111111111111111111111111111111111111111111111111111111111111111111111111111111111111111111111111111111111111111111111111
